#############
#       .   #
# $$$$$$$#  #
# $      #  #
# $$$$$$ #  #
#           #
#$$$$$$$ #  #
#@       ####
##########