##########
#       .####
# ########  #
# #      #  #
# ###### #  #
#        #  #
######## #  #
#@       ####
##########