#############
#       .   #
# ########  #
# #      #  #
# ###### #  #
#           #
######## #  #
#@       ####
##########