######
#@   #
#   .#
#   $#
#    #
######