######
#@   #
#  . #
# $  #
#    #
######