########
# ..#  #
# ..# $###
# $##    #
##   $   #
 #@##  ###
 #    ##
 ### $#
   #  #
   ####