########
#   #  #
# . #  ###
# $##    #
##       #
 #@##  ###
 #    ##
 ###  #
   #  #
   ####